00000000000000000000000000000000000000000000000000
00000000000000000000000000000000000000000000000000
00000000000000000000000000000000000000000000000000
00000000000000000000000000000000000000000000000000
00000000000000000000000000000000000000000000000000
00003333000003333000003300330000333330000333333000
00033333300033333300003300330000333333000333333000
00033000300033003300003300330000330033000003300000
00033000000033003300003300330000333333000003300000
00033000000033003300003300330000333330000003300000
00033000000033003300003300330000330000000003300000
00033000300033003300003300330000330000000003300000
00033333300033333300003333330000330000000003300000
00003333000003333030000333300000330000000003300000
00000000000000000003000000000000000000000000000000
00000000000000000000000000000000000000000000000000
00000000000000000000000000000000000000000000000000
00000000000000000000000000000000000000000000000000
00000000000000000000000000000000000000000000000000
00000000000000000000000000000000000000000000000000
00000000000000000000000000000000000000000000000000
00000000000000000022220000022220000000000000000000
00000000000000000222222222222222000000000000000000
00000000000000000222000222000222000000000000000000
00000000000000000220000000000022000000000000033333
33333000000000000220000000000022000000000000033333
33333000000000000022000000000220000000000000000000
00000000000000000002000000000200000000000000000000
00000000000000000002200000002200000000000000000000
00000000000000000000222000222000000000000000000000
00000000000000000000002222200000000000000000000000
00000000000000000000000020000000000000000000000000
00000000000000000000000000000000000000000000000000
00000000000000000000000000000000000000000000000000
00000000000000000000000000000000000000000000000000
00000000000000000000033333330000000000000000000000
00000000000000000000033333330000000000000000000000
00000000000000000000033000330000000000000000000000
00000000000000000000033000330000000000000000000000
00000000000000000000033000330000000000000000000000