00000000000000000000000000000000000000000000000000
00000000000000000000000000000000000000000000000000
00000000000000000000000000000000000000000000000000
00000000000000000000000322300000000000000000000000
00000000000000000000003222230000000000000000000000
00000000000000000000032222222000000000000000000000
00000000000000000000222233222200000000000000000000
00000000000000000002222233222220000000000000000000
00000000000000000022222233222222000000000000000000
00000000000000000322223333332222200000000000000000
00000000000000003222223333332222230000000000000000
00000000000000032222223322332222223000000000000000
00000000000000022222233223333222222000000000000000
00000000000000322222333223333322222200000000000000
00000000000003222222332233223322222230000000000000
00000000000002222222332233233322222220000000000000
00000000000032222233322332233333222223000000000000
00000000000022222233323332332333222222000000000000
00000000000322222233333333333333222222200000000000
00000000000222223333333333333333322222230000000000
00000000003222223332222222222333332222230000000000
00000000002222223322222222223322332222220000000000
00000000032222233323333333333323333222223000000000
00000000032222333223333333333223333322222000000000
00000000022222232233222222332233233222222000000000
00000000322223332233223333332233223332222300000000
00000000322233322332233333322332233333222200000000
00000000222223322332233233323332333332222200000000
00000000222233333333333333333333333333222230000000
00000000222333333333333333333333333333322230000000
00000000223332233233223322332233233223332230000000
00000000222222222222222222222222222222222230000000
00000000222222222222333333333322222222222200000000
00000000032222330000000000000000003322222300000000
00000000000000000000000000000000000000000000000000
00000000000000000000033333330000000000000000000000
00000000000000000000033333330000000000000000000000
00000000000000000000033000330000000000000000000000
00000000000000000000033000330000000000000000000000
00000000000000000000033000330000000000000000000000